1. Глаголы, которые не меняются (остаются одинаковыми):

bet – bet – bet – ставить (դնել խաղադրույք)
broadcast – broadcast – broadcast – транслировать (հեռարձակել)
burst – burst – burst – взрываться (պայթել)
cost – cost – cost – стоить (արժենալ)
cut – cut – cut – резать (կտրել)
hit – hit – hit – ударять (հարվածել)
hurt – hurt – hurt – ранить, болеть (վիրավորել, ցավել)
let – let – let – позволять (թողնել)
put – put – put – класть (դնել)
read – read – read – читать (կարդալ)
set – set – set – устанавливать (տեղադրել)
shut – shut – shut – закрывать (փակել)
split – split – split – раскалывать (բաժանել)
spread – spread – spread – распространять (տարածել)

2. Глаголы, которые меняют одну или пару букв:

bend – bent – bent – гнуть (ծռել)
bleed – bled – bled – кровоточить (արյունահոսել)
bring – brought – brought – приносить (բերել)
build – built – built – строить (կառուցել)
buy – bought – bought – покупать (գնել)
catch – caught – caught – ловить (բռնել)
dig – dug – dug – копать (փորել)
feel – felt – felt – чувствовать (զգալ)
find – found – found – находить (գտնել)
get – got – got – получать (ստանալ)
hang – hung – hung – вешать (կախել)
have – had – had – иметь (ունենալ)
hear – heard – heard – слышать (լսել)
keep – kept – kept – хранить (պահել)
lay – laid – laid – класть (դնել)
lead – led – led – вести, руководить (ղեկավարել)
leave – left – left – покидать (լքել)
lend – lent – lent – одалживать (պարտքով տալ)
light – lit – lit – зажигать (վառել)
lose – lost – lost – терять (կորցնել)
make – made – made – делать (անել)
mean – meant – meant – значить (նշանակել)
meet – met – met – встречать (հանդիպել)
pay – paid – paid – платить (վճարել)
say – said – said – говорить (ասել)
sell – sold – sold – продавать (վաճառել)
send – sent – sent – отправлять (ուղարկել)
sit – sat – sat – сидеть (նստել)
sleep – slept – slept – спать (քնել)
spend – spent – spent – тратить (ծախսել)
stand – stood – stood – стоять (կանգնել)
teach – taught – taught – учить (սովորեցնել)
tell – told – told – рассказывать (պատմել)
think – thought – thought – думать (մտածել)
win – won – won – выигрывать (հաղթել)

3. Глаголы, которые меняются кардинально:

be – was/were – been – быть (լինել)
become – became – become – становиться (դառնալ)
begin – began – begun – начинать (սկսել)
bite – bit – bitten – кусать (կծել)
blow – blew – blown – дуть (փչել)
break – broke – broken – ломать (կոտրել)
choose – chose – chosen – выбирать (ընտրել)
come – came – come – приходить (գալ)
do – did – done – делать (անել)
draw – drew – drawn – рисовать (նկարել)
drink – drank – drunk – пить (խմել)
drive – drove – driven – водить (վարել)
eat – ate – eaten – есть (ուտել)
fall – fell – fallen – падать (ընկնել)
fly – flew – flown – летать (թռչել)
forget – forgot – forgotten – забывать (մոռանալ)
forgive – forgave – forgiven – прощать (ներել)
freeze – froze – frozen – замерзать (սառել)
give – gave – given – давать (տալ)
go – went – gone – идти (գնալ)
grow – grew – grown – расти (աճել)
hide – hid – hidden – прятать (թաքցնել)
know – knew – known – знать (իմանալ)
ride – rode – ridden – ездить (քշել)
ring – rang – rung – звонить (զանգել)
rise – rose – risen – подниматься (բարձրանալ)
see – saw – seen – видеть (տեսնել)
shake – shook – shaken – трясти (ցնցել)
sing – sang – sung – петь (երգել)
sink – sank – sunk – тонуть (խորտակվել)
speak – spoke – spoken – говорить (խոսել)
steal – stole – stolen – красть (գողանալ)
swear – swore – sworn – клясться (երդվել)
swim – swam – swum – плавать (լողալ)
take – took – taken – брать (վերցնել)
tear – tore – torn – рвать (պատռել)
throw – threw – thrown – бросать (նետել)
wake – woke – woken – просыпаться (արթնանալ)
wear – wore – worn – носить (կրել)
write – wrote – written – писать (գրել)